3 13 31
###############################
#p  ** **   1 *   2           #
# # # #*# # # # # # # # # # # #
#*     ** * *  *   * ** 3 *   #
# # # # # #*# # # # # # #*# # #
#*   *s*    *** * x **        #
# # # # # # # # # # # # # #*# #
#   1*     *        * 2  **  3#
# #*# # #*#*#*#*# # #1# # #*# #
#   1    *   *2*  3 *   *     #
#*# # # # # # # # # # #*# # #*#
# *    * **    ** ***     1   #
###############################