5 13 31
###############################
#p     b* *     *   *  * * *  #
# #*# #s# # #*#*# # # #*#*#*# #
#* *  *     * *s *   f**  * * #
# #*# # # #*# # #*#*# # #*# #*#
#        x* **  *f *          #
# # # # # #*# # # #*# # # # # #
#*1 s      *  *      *        #
# # # # #*# # # #*#*# #b# # # #
#*    **  *       *     *     #
# #*# # # # # # #*# # # # #f# #
#           *   *  *    *     #
###############################